a	Determiner	
bit	Quantifier	
couple	Quantifier	
aboard	Prepositions	
about	Prepositions	
above	Prepositions	
absent	Prepositions	
according	Conjunction	
accordingly	Conjunction	
across	Prepositions	
after	Prepositions	Conjunction
against	Prepositions	
ahead	Prepositions	
albeit	Conjunction	
all	Quantifier	
along	Prepositions	
alongside	Prepositions	
although	Conjunction	
amid	Prepositions	
amidst	Prepositions	
among	Prepositions	
amongst	Prepositions	
an	Determiner	
and	Conjunction	
another	Determiner	
any	Quantifier
anybody	Pronoun	
anyone	Pronoun	
anything	Pronoun	
around	Prepositions	
as	Prepositions	Conjunction
aside	Conjunction	
astraddle	Prepositions	
astride	Prepositions	
at	Prepositions	
away	Prepositions	
bar	Prepositions	
barring	Prepositions	
because	Conjunction	
before	Prepositions	Conjunction
behind	Prepositions	
below	Prepositions	
beneath	Prepositions	
beside	Prepositions	
besides	Prepositions	
between	Prepositions	
beyond	Prepositions	
both	Determiner	
but	Conjunction	
by	Prepositions	
can	Modal	
certain	Pronoun	
circa	Prepositions	
close	Prepositions	
concerning	Prepositions	
consequently	Conjunction	
considering	Prepositions	Conjunction
could	Modal	
dare	Modal	
despite	Prepositions	
down	Prepositions	
due	Conjunction	
during	Prepositions	
each	Quantifier	
either	Conjunction	Determiner
enough	Quantifier	
every	Determiner	
everybody	Pronoun	
everyone	Pronoun	
everything	Pronoun	
except	Prepositions	
excluding	Prepositions	
failing	Prepositions	
few	Determiner	
fewer	Quantifier	
following	Prepositions	
for	Prepositions	Conjunction
from	Prepositions	
given	Prepositions	
heaps	Quantifier	
hence	Conjunction	
however	Conjunction	
if	Conjunction	
in	Prepositions	
spite	Conjunction	
view	Conjunction	 
including	Prepositions	
inside	Prepositions	
instead	Conjunction	
into	Prepositions	
it	Pronoun	
its	Determiner	
itself	Pronoun	
less	Prepositions	Quantifier
like	Prepositions	
little	Quantifier	
loads	Quantifier	
lots	Quantifier	
many	Quantifier	
may	Modal	
might	Modal	
minus	Prepositions	
more	Quantifier	
most	Quantifier	
much	Quantifier	
must	Modal	
near	Prepositions	
need	Modal	
neither	Determiner	Conjunction
nevertheless	Conjunction	
next	Prepositions	
no	Determiner	
nobody	Pronoun	
none	Quantifier	
nor	Conjunction	
nothing	Pronoun	
notwithstanding	Prepositions	
of	Prepositions	
off	Prepositions	
on	Prepositions	
once	Conjunction	
one	Determiner	
onto	Prepositions	
opposite	Prepositions	
or	Conjunction	
other	Determiner	
ought	Modal	
our	Determiner	
out	Prepositions	
outside	Prepositions	
over	Prepositions	
part	Prepositions	
past	Prepositions	
pending	Prepositions	
per	Prepositions	
pertaining	Conjunction	
plenty	Quantifier	
plus	Prepositions	Conjunction
regarding	Prepositions	
respecting	Prepositions	
round	Prepositions	
save	Prepositions	Conjunction
saving	Prepositions	
several	Determiner	
shall	Modal	
should	Modal	
similar	Conjunction	
since	Prepositions	Conjunction
so	Conjunction	
some	Quantifier	
somebody	Pronoun	
something	Pronoun	
such	Determiner	
than	Prepositions	Conjunction
that	Conjunction	
the	Determiner	
them	Determiner	
themselves	Pronoun	
then	Conjunction	
thence	Prepositions	
therefore	Conjunction	
these	Determiner	
they	Pronoun	
this	Determiner	
tho	Conjunction	
those	Determiner	
though	Conjunction	
through	Prepositions	
throughout	Prepositions	
thru	Prepositions	
till	Conjunction	
to	Prepositions	
toward	Prepositions	
towards	Prepositions	
under	Prepositions	
underneath	Prepositions	
unless	Conjunction	
unlike	Prepositions	
until	Prepositions	Conjunction
unto	Prepositions	
up	Prepositions	
upon	Prepositions	
us	Determiner	
used	Modal
various	Quantifier	
versus	Prepositions	
via	Prepositions	
wanting	Conjunction	
what	Conjunction	
whatever	Conjunction	
when	Conjunction	
whenever	Conjunction	
where	Conjunction	
whereas	Conjunction	
wherever	Conjunction	
whether	Conjunction	
which	Conjunction	
whichever	Conjunction	
while	Conjunction	
whilst	Conjunction	
who	Conjunction	
whoever	Conjunction	
whom	Conjunction	
whomever	Conjunction	
whose	Conjunction	
will	Modal	
with	Prepositions	
within	Prepositions	
without	Prepositions	
would	Modal	
yet	Conjunction	